9 11
WWWWWWWEW
WPW...WHW
W.W.W.W.W
W.W.W.W.W
W.W.W.W.W
W.W.W.W.W
W.W.W.W.W
W.W.W.W.W
W.W.W.W.W
W...W...W
WWWWWWWWW
